xxxxxxxxxxxxxxxxxxxxxxxx
x3333333333xx3333333333x
x3000020000xx0000002003x
x3000000000000000000003x
xxxxx00000000000000xxxxx
xxxxx00000001000000xxxxx
x3000000000000000000003x
x3002000000xx0000200003x
x3333333333xx3333333333x
xxxxxxxxxxxxxxxxxxxxxxxx 