xxxxxxxxxxxxxxxxxxxxxxxx
xx333x333x333x333x3333xx
xx000x000x000x000x0010xx
x000000000000000000000xx
x0020002000200020002000x
x0000000000000000000000x
x0000000000000000000000x
x00x000x000x000x000x000x
x33x333x333x333x333x333x
xxxxxxxxxxxxxxxxxxxxxxxx 