xxxxxxxxxxxxxxxxxxxxxxxx
x3333xx333333333333333xx
x3333xx0000000000000003x
x3333300002000000000003x
xxxxx000000000000000003x
x3000000020000002000003x
x30000000000000000000xxx
x33x3000001000000000003x
x3xxx333333333333333333x
xxxxxxxxxxxxxxxxxxxxxxxx
